####################
#                  #
#                  #
#                  #
#                  #
#       @          #
#                  #
#        (_)       #
#                  #
#                  #
#                  #
####################