&&&&&&&&&&&&&&&&&&&&
& &      &         &
&   && &&& &&&&&&& &
&& &&      &   &&  &
&  &&&&&& &&^&    &&
&&&& &&    &+&&&&&&&
& &     &&&&+&    &&
&   & &  & &&&  &  &
& & &&&&&&      & &&
& &&&   &&&&&&&&&   
&     &           &&
&&&&&&&&&&&&&&&&&&&&