################# ##
#              *#-##
#           #####  #
#                   
#               ## #
#                # #
#                # #
# ####           # #
#    #####       # #
#### #   ######### #
#++  #-#           #
###### #############