&&&&&&&&&&&&&&&&&&&&
&    >             &
&    &  &&&&&&&&&  &
&    &  &       &  &
&    &  & &&&&& &  &
&    &  & &   & &  &
&    &  & & & & &  &
&    &  & &&& & &  &
&    &  &     & &  &
&    &  &&&&&&& &  &
&****&          &  &
&&&&&&&&&&&&&&&&& &&