######## ###########
       #-#      #**#
######     ####    #
#  # ############  #
#  #  +# #      #  #
#    ### #### ###  #
###  #   #    #    #
#                # #
#### #############?#
#     #   #!#    # #
##  #   #   #  #   #
################## #