####################
(     #   #     #   
##### # #   # ###  #
      # #   #   #  #
####    #   #   #  #
#**# #####  #   #  #
#  #   # #  #####  #
#  ## ##           #
#      #   # # #####
#########  # # #   #
#          # #   #*#
### ################