&&&&&&&&&&&&&&&&&&&&
&+  &+            *&
&&& &&&&&&&&&^&&&&&&
&+   &     &    &**&
&&&& &&&&  & &&&&  &
&       >          &
&&&&&&&&&&&  &&&& &&
&            &     &
&& & &&&&&   & &&&&&
 ] &     &   & &   &
&& & & & & &&&   & &
&&&&&&&& &&&&&&&&&&&