###################
#                 #
# ---   ---   --- #
# | |   | |ooo| | #
# ---   ---   --- #
#  o           o  #
# ---   ---   --- #
# | |ooo| |ooo| | #
# ---   ---   --- #
#  o     o     o  #
# ---   ---   --- #
# | |   | |ooo| | #
# ---   ---   --- #
#                 #
###################